NO ./textures/7.xpm
SO ./textures/9.xpm
WE ./textures/11.xpm
EA ./textures/4.xpm
F 50,50,50
C 37, 153,205

111111111111111111111111111
111111111000111111111111111
111111111000111111111111111
111111111000111111111111111
111111111000111111111111111
111111111000111111111111111
1111111110N0111111111111111
111111111000111111111111111
111111111111111111111111111


