NO ./textures/12.xpm
SO ./textures/13.xpm
WE ./textures/14.xpm
EA ./textures/12.xpm
F 210,180,140
C 37,53,105

11111111111111111111111111111111
10100000001100000000000000000001
11110000011100000000000000000001
10010000000000000000000000000001
11111111101100001110000000000001
10000000011000001110111111111111
11110111111111011100000010000001
11110100001111011101010010000001
11000000000101011100000010000001
10000000000000001100000010000001
100000N0000000001101010010000001
11000101110101011111011110000111
11110111111110101110111101000001
11111111111111111111111111111111

